{
	"name": "Ancient Europe",
	"name_de": "Antikes Europa",
	"size": "98x78",
	"tile_size": 40,

	"tile_map":
	[
		"WWWWWWWWWWWWWWWWWWWWWWWWWWWWWWWWWWWWWWWWWGGMGGGGGGGGGWWWGGGGGGGGGGGGGGGGGGGGGGGGGGGGGGGGGGGGGGMMGGG",
		"WWWWWWWWWWWWWWWWWWWWWWWWWWWWWWWWWWWWWWWWWGGMMGGFFGGGGWWGGGGGGGGGGGGGGGGGGGGGFFFFGGGGGGGGGGGGGGMMMGG",
		"WWWWWWWWWWWWWWWWWWWWWWWWWWWWWWWWWWWWWWWGGGMMGGFFFGGGGWGGGGFFFGGGGGGGGGGGGGFFFFFFFFFFFFGGGGGGGGGMMGG",
		"WWWWWWWWWWWWWWWWWWWWWWWWWWWWWWWWWWWWWWGGGMMMGGFGFGGGWGGGGFFFFFGGGGGGGGGGGFFFFFFFFFFFFFFGGGGGGGGGGGG",
		"WWWWWWWWWWWWWWWWWWWWWWWWWWWWWWWWWWWWWGGFFFFFGFFFGGGWWGGGFFFFFFFFGGGGGGGGGGFFFFFFFFFFFFGGGGGGGGGGGMG",
		"WWWWWWWWWWWWWWWWWWWWWWWWWWWWWWWWWWWWGGGGFFFFFFFFGGWWGGGGFFFFFFFFGGGFFGGGGGGFFFFFFFFFFGGGGGGGGGGGMMG",
		"WWWWWWWWWWWWWWWWWWWWWWWWWWWWWWWWWWWGMMMMFFFFFFFFGGWWGGGGGGFFFFGGGGGGFFGGGGGGFFFFFFFFGGGGGGGGGGGGGGG",
		"WWWWWWWWWWWWWWWWWWWWWWWWWWWWWWWWWWWWMMMFFMMMFFFGGWWWGGGGGGGGGGGFFGGGFFGGGGGGGGGFFFFGGGGGGGGGGGGGGMM",
		"WWWWWWWWWWWWWWWWWWWWWWWWWWWWWWWWWWWWGGFFMMMMGFGGGWWWGGGGGGGGGGFFFGGGGGGGGGGGGGGGGGGGGGGGGGGGGGGGGMM",
		"WWWWWWWWWWWWWWWWWWWWWWWWWWWWWWWWWWWGMGFFFFGMGGGGGGWWWGGGGGGGGGGGFGGGGGGGGGGGGGGGGGGGGGGGGGGGGGGGGMM",
		"WWWWWWWWWWWWWWWWWWWWWWGGGGGWWWWWWWWGMMGGFFGGGGGGFFFFWGGGGWWWWGGGGGGGGGGGGGGMGGGGGGGGGGGMMGGGGGGGGMM",
		"WWWWWWWWWWWWWWWWWWWWGGGGGWWWWWWWWWGGMMGGGGGGGGGGFFFWWWWGWGGGGGGGGGGGGGGGGGMMMGGGMMMMGGMMMGGGGGGGMMM",
		"WWWWWWWWWWWWWWWWWWWWWGGGGGGWWWWWWWWWMMMGGGFGGGGGFFFWWWWWGGGGGGGGGGGGGGGGGGGMMGGGMMMGGGGGGGGGGGGGGGG",
		"WWWWWWWWWWWWWWWWWWWWGGGGGGGWWWWWWWWGGMGGWGFFGGGGFGWWWWGGGGGGGGGGGGGGGGGGGGGGGGGGGGGGGGGGGGGGGGGGGGG",
		"WWWWWWWWWWWWWWWWWWWWGGGGGGWWWWWWWWWWWGGWWGGFFFGGGWWWWWGGGGGGGGGGGGGGGMMMGGGGGGGGGGGGGGGGGGGGGGGGGGG",
		"WWWWWWWWWWWWWWWWWGGWWGGGGWWWWWWWWWWWWWWWWWGFFFGGWWWWWWWWGGGGGGGGGGGGGMMMMGGGGGGGGGGGGGGGGGGGGGGGGGG",
		"WWWWWWWWWWWWWWGWGGGGWGMMWWWWWWWWWWWWWWWGWWGFFFGGWWGWWWGWGGGGGGGGGGGGGGGGGGGGGGGGGGGGGGGGGGGGGGGGGGG",
		"WWWWWWWWWWWWWGGGGFFGWGMMMWWWWWWWWWWWWGGGG=GGFFGG=GGWWGGGGGGGGGGGGGGGGGGGGGGGGGGGGGGGGGGGGFFFFFFGGGG",
		"WWWWWWWWWWWWGGGGFFFGWGGFFFWWWWWWWWWWWGGGGWGGGGGGWGGWWGGGGGGGGFFGGGGGGGGGGGGGGGGGGGGGGGGFFFFFFFFGGGG",
		"WWWWWWWWWWWWWGGGFFFWWGGGFFWWWWWWWWWWFFGGWWWGGGGGWWWWWGGGGGGGFFFFFGGGGGGGGGGGGGGGGGGGGGFFFFFFFFFGGGG",
		"WWWWWWWWWWWGGGGGGGWWWWGGGGGWWWWWWWWWWFGGWGWGGGWWWWWWWGGGGGGGFFFFFGGGGGGGGGGGGGGGGGGGGGFFFFFFFGGGGGG",
		"WWWWWWWWWWWGFFFGGGWGGWGGFFGWWWWWWWWWWFGGGGWWGWWWWWWWWGGGGGGFFFFFFFGGGGGGGGGGGGGGGGGGGGFFFGGFFGGGGGG",
		"WWWWWWWWWWGGFFFGGG=GGGGFFGGWWWWWWWWWWGGGWWWWWWWGGGWWGGGGGGGFFFFFFFGGGGGGGGGGGGGGGGGGGGGFGGGGGGGGGGG",
		"WWWWWWWWWWWGFFGWWWWGGGGGGGGGWWWWWWWWGGGGGWGGWWGGGGGGGGGGGGGGGFFFFFGGGGGGGGGGGGGGGGGGGGGGGGGGGGGGGGG",
		"WWWWWWWWWWWWWWWWWWGGFFFFGGGGWWWWWWWWGGGGGGGGGGGGGGGGGGGGGGGGGGFFGGGGGGGGGGGFFFFFFGGGGGGGGGGGGGGGGGG",
		"WWWWWWWWWWWWWWWWWWWGFFFFGGGGGWWWGGGGGGGGGGGGGGGGGFFGGGGGGGGGGGGGGGGGGGGGGFFFFFFFFFGGGGGGGGGGGGGGGGG",
		"WWWWWWWWWWWWWWWWWWGGGFFGGGGGWWWGGGGGGGFFFFFGGGFFFFFFFFGGGGGGGGFGGGGGGGGGFFFFFFFFFFFGGGGGGGGGGGGGGGG",
		"WWWWWWWWWWWWWWWGGGGGGFGGGGGWWWWGGGGGGGFFFFFGGGFFFFFFFFGGGGGGGFFGGGGGGGGFFFFFFFFFFFFFGGGGGGGGGGGGGGG",
		"WWWWWWWWWWWWWWWGGGGWGGGGGGGWWWGGGGGGGFFFFFFGGGGFFFFFFGGGGGGFFFFFGGGGGGFFFFFGGGGGGFFFGGGGGGGGGGGGWWW",
		"WWWWWWWWWWWWWWWWWWWWWHWWWWWGGGGGGGGGFFFFFFFGGGGGFFFFFGGGGGGFFFFFGGGGGFFFGGGGGGGGGGGFGGGGGGGFFGGWWWW",
		"WWWWWWWWWWWWWWWWWWWWWGGWWGGGGGGGGGGGFFFFFGGGGGGGGGFFGGGGGGGGFFFGGGGGFFFGGGGGGGGGGGGFGGGGFFFFGGGWWWW",
		"WWWWWWWWWWWWWWWWWWGWWGGGGGGGGGGGGGGGGGGGGGGGGGGGGGGGGGGGGGGGGGGGGGGGFFGGGGGGGGGGGGGGGGGFFFFFGGGWWWW",
		"WWWWWWWWWWWWWWWWGGGGGGGGGGGGGGGGGGGGGGGGGGGGGGGGGGGGGGGGGGGGGGGGGGGGFFGGGGGGGGGGGGGGGGGFFFFGGGWWWGG",
		"WWWWWWWWWWWWWWWWGGGGGGGGGFFFFFFFGGGGGGGGGFFFGGGGGGGFGGFFGGGGGGGGGGGGGGGGGGGGGGGGGGGGGGGFFGGGGWWWWWG",
		"WWWWWWWWWWWWWWWWGGGGGGGGFFFFFFFGGGGGGGGGFFFMGGGGGGFFFFMFGGGGGGGGGGGGGGGGGGGGGGGGGGGGGGGGGGGGGGWWWWW",
		"WWWWWWWWWWWWWWWWWWGGGGGGFFFFFFGGGGGGGGGFFFMMGGGGFFFFFMMFGGGGGGGGGGGGGGGGGGGGGGGGGGGGGGGGGGGGGGWWWWW",
		"WWWWWWWWWWWWWWWWWWWWGGGGFFFFFFGGGGGGGGFFFMMMGGGGMFFFFFFGGMMMMGGGGGGGGGGGGGGGGWWGGGGGGGGGGGGGGGGWWWW",
		"WWWWWWWWWWWWWWWWWWWGGGGGGGGGFFGGGGGGGFFFMMMMGGGGMMGGGGGGGGMMMGGGGGGGGGGGFGGWWWWWGGGGGMGGGGGGGGGGWWW",
		"WWWWWWWWWWWWWWWWWWWWGGGGGGGGFFFGGGGGFFFFMMMMMGGGGGGGGGGGGGGGMMGGGGGGGGGFFGGGWWWGGGMMMMMMGGGGGGGGGWW",
		"WWWWWWWWWWWWWWWWWWWWGGFGGGGGFFFFGGMMMMMMMMGMMGGGGGGGGGGGGGGGGGGGGGGGGWWFFFGGGGGGGGGMMMMMMGGMMGGGGGW",
		"WWWWWWWWWWWWWWWWWWWWGGFFFGGGFMMMGGGMMMMMGGGGGGGGGGGGGGGGGGGGGGGMGGGGGWWGFFFFGGWWWGGGGMMMGGGMMMGGGGG",
		"WWWWWWGGGGGWWWWWWWWWGGGFFGGGMMMMGGMMGGGGGFFFFFFFFGGGGGGGGGGGMMMMMGGGWWWGGFFFGWWWWWWGGGGGGGGMMGGGGGG",
		"WWWWWWGGGGGGGGWWWWWWGGGGFGGGMMGGGMMMGGGGGFWFFMFFFFFGGGGGGGGGMMMMGGGGWWWWWGGGWWWWWWWWWWGGGGGGGGGGGGG",
		"WWWWWWWGGGGGGGGGWWMMGGGGGGGGMMGGGGMGGGGGFFWFFMMFFFFGGGMMMMGGGGGGGGGWWWWWWWWWWWWWWWWWWWGGGGGGGGGGGGG",
		"WWWWWWWGFGGGGGGGGGMMGMGGGGGGGGGMMGGGGGGGFFWWFMMMFFFGGGMMMMMGGGGGGGGWWWWWWWWWWWWWWWWWWWWGGGGGGGGGGGG",
		"WWWWWWGGFFFFFFGGGGMMMMMGGGGGGGMMMMGWGGGGFWWWFFMMMMFFGGGGFMMFGGGGGGGWWWWWWWWWWWWWWWWWWWGGGGGGGGGGGGG",
		"WWWWWWGGGFFFGGGGGGGMMMGGGGGWWGGGGWWWWWGMMMWWWFMMMMMFGGGGFFFFMGGGGGGWWWWWWWGGGGGGGGGGGGGGGGGGGGGGGGG",
		"WWWWWWGGGFGGGGGGGGGGMGGGGGGWWWWWWWWWWWGMMMGWWWWGGGMMMGGFFFMMMGGGGGWWWWWWWGGGGGGGGGGGGGGGGGGGGMGGGGG",
		"WWWWWGGGGGGGMMMGGGGGGGGMMMWWWWWWWWGGGWGGMMGGWWWGGGGMMMGGFFMMGGGGGGWWWWWWGGGGGGGGFFGGGGGGGGMMMMMGGGG",
		"WWWWGGGGGGMMMMMMGGGGGGMMMMWWWWWWWWGGG=GGGGGGGWWWGGGGGGGGGGGGGGGGGGGWWWWGGGGGGGGFFFFGGGGGGGMMMMGGGGG",
		"WWWGGGGGGGMMMMMGGGGGGGGMWWWWWWWWWWGGWWWWGGGFFGGWWWGGGGGFFFFFFGGGGGG=GGGGGGGGGGFFFFGGGGGGGGGGGGGGGGG",
		"WWWGGFGGGGGGGGGGGGGGGGWWWWWWWWWWWWWWWWWWGGGGFFGGWWWWGGGFFFFFFGGGGWWWGGGGGGGGGGFFFGGGGGMGGGGGGGMMMGG",
		"WWWWGFFFGGGGGGGGGGGGGWWWWWWWWWWWWGGGGWWWWWGGGFFFWWWWMMGGGFFGGWWWWWWGGGGFFFFGGGGFFGGGGGMMGGGGGGMMMMG",
		"WWWWGFFFGGGGGGGGGGGGWWWWGWGGWWWWWGGGGWWWWWWGGGFFGGWWGMMMGGGGGWWWGGGGGGGFFFFGGGGGGGGGGGGGGGGGGGGMMGG",
		"WWWWGGFFGGGGGGGGGGGGWWWGGGWGWWWWWWGGGWWWWWWWGGGGGGGWGGMMMGGGWWWWGGGGGFFFFFFGGGGGGGGGGGGGGGGGGGGGGGM",
		"WWWWGGGGGGGGGGGGGGGGGWGWWGWWWWWWWGGGGWWWWWWWGGGGGGGWWGMGGGGWWWWGGGGGGFFFFGGGGGGGMMGGGMMGGGGGGGGGGGM",
		"WWWWWWGGGGGGGGGGGGGWWWWWWWWWWWWWWGGGGWWWWWWWWWGGGWWWWGGGGGGWWWWWGGGGGFFGGGGGGGGMMMGGGMMGGGGGGGGGGGG",
		"WWWWWWWGGGGGGGGGGGGWWWWWWWWWWWWWWGGWWWWWWWWWWWGGGWWWWWWGGGGGGWWWWGGGGGGGGGGGGGMGGMGGGGMGGGMMMMGGGMG",
		"WWWWWWWWGGGGGGGGWWWWWWWWWWWWWWWWWWWWWWWGGGWWWWGGWWWWWWWWWWWGGGWWWGGGGGGGGGGGGGGGGGGDDGGGGGMMMMGGGMM",
		"WWWWWWWWGGWWWGWWWWWWWWWWWWWWWWWWWWWWWWWWGGGGGGGWWWWWWWWGGGGGGGWWWGGGGGGGGGGGGGGWWGDDDDDDDGGGMGGGGGM",
		"WWWWWWWWWHWWWWWWWWWWDDDDDDDWWDDWWWGGGGWWGGGGGGWWWWWWWWWGGFFGWWWWWWWWWGGGWGGGGWWGWWDDDDDDDDDGGGDDDGG",
		"WWWWWWWGGGGGGGWWGDDDDDDDDDDDDDDDDGGGGGGWWWFFGGWWWWWWWWWWGGFGWWWWWWWWWWWWWWWGWWGGWWDDDDDDDDDDDDDDDDD",
		"WWWWWDDDDDDMGGGGGGDDDDDDDDDDDDDDDDDDDGGWWWWFFFWWWWWWWWWWGGFFWWWWWWWWWWWWWWWGGGGWWWDDDDDDDDDDDDDDDDD",
		"WWWDDDDDDDMMDDDMMMDDDDDDDDDDDDDDDDDDGGWWWWWWWWWWWWWWWWWWWWWWWWWWWWWWWWWWWWWGGGWWWGDDDDDDDDDDDDDDDDD",
		"WDDDDDDDDDMDDMMMMMDDDDDDDDDDDDDDDDDDDGGWWWWWWWWWWWWWWWWWWWWWGGGGGWWWWWWWWWWWGWWWWGGDDDDDDDDDDDDDDDD",
		"DDDDMMMMMDDDMMMDDDDDDDDDDDDDDDDDDDDDDGGWWWWWWWWWWWWWWWWWWWWWGWGGGWWWWWWWWWWWWWWWWGDDDDDDDDDDDDDDDDD",
		"DDDDMMMMMDDDMMDDDDDDDDDDDDDDDDDGGDDDGGWWWWWWWWWWWWWWWWWWWWWWWWWWWWWWWWWWWWWWWWWWWGGDDDDDDDDDDDDDGGD",
		"DDDDDMMDDDDDDDDMMDDDDDDDDDDDDDGGGGGGGWWWWWWWWWWWWWWWWWWWWWWWWWWWWWWWWWWWWWWWWWWWGGGGDDDDDDGGDDDDGGG",
		"DDDDDDDDDDDDDDDMMMDDDDDDDDDDDDDDDGGWWWWWWWWWWWWWWWWWWWWWWWWWWWWWWWWWWWWWWWWWWWWWGGGGGDDDDGGGGDDDGGD",
		"DDDDDDDDDDDDDDDDDDDDDDDDDDDDDDDDDDDDDDDDWWWWWWWWWWWWWWWWWWWWWWWWWWWWWWWWWWWWWWWWGGGGGDDDDDDGGDDDDGD",
		"DDDDDDDDDDDDDDDDDDDDDDDDDDDDDDDDDDDDDDDDDDDDDWWWWWWWWWWWDDDDDWWWWWWWWWWWWWWWWWWWGGGGDDDDDDDDDDDDDDD",
		"DDDDDDDDDDDDDDDDDDDDDDDDDDDDDDDDDDDDDDDDDDDDDDDWWWWWWWDDDDDDDDDDWWWWWWWWWGGGGGGGGGGDDDDDDDDDDDDDDDD",
		"DDDDDDDDDDDDDDDDDDDDDDDDDDDDDDDDDDDDDDDDDDDDDDDWWWWWWWDDDDDDDDDDDDDDDGGWGGGGGGGGGGDDDDDDDDDDDDDDDDD",
		"DDDDDDDDDDDDDDDDDDDDDDDDDDDDDDDDDDDDDDDDDDDDDDDDDWWWWWDDDDDDDDDDDDDDDDGGGGGGGGGGGDDDDDDDDDDDDDDDDDD",
		"DDDDDDDDDDDDDDDDDDDDDDDDDDDDDDDDDDDDDDDDDDDDDDDDDDDWWWDDDDDDDDDDDDDDDDDDDGGGGGGGGDDDDDDDDDGGGDDDDDD",
		"DDDDDDDDDDDDDDDDDDDDDDDDDDDDDDDDDDDDDDDDDDDDDDDDDDDDDDDDDDDDDDDDDDDDDDDDDDGGGGGGGDGGDDDDDDGGGDDDDDD",
		"DDDDDDDDDDDDDDDDDDDDDDDDDDDDDDDDDDDDDDDDDDDDDDDDDDDDDDDDDDDDDDDDDDDDDDDDDDDGGGGGGGGDDDDDDDDGGDDDDDD",
		"DDDDDDDDDDDDDDDDDDDDDDDDDDDDDDDDDDDDDDDDDDDDDDDDDDDDDDDDDDDDDDDDDDDDDDDDDDDGDGGWGGGGGDDDDDDDDDDDDDD",
		"DDDDDDDDDDDDDDDDDDDDDDDDDDDDDDDDDDDDDDDDDDDDDDDDDDDDDDDDDDDDDDDDDDDDDDDDDDDDDDGGWGWGGGDDDDDDDDDDDDD"
    ],

    "cities":
    [
			"0, 1, 28, 45",
			"0, 1, 53, 46",
			"0, 1, 65, 48",
			"0, 1, 77, 54",
			"0, 1, 46, 39",
			"0, 1, 52, 75",
			"0, 1, 89, 60",


    	"1, 2, 41, 51, Rome",
			"1, 1, 34, 52",
			"1, 1, 46, 56",

	    "2, 2, 58, 62, Sparta",
			"2, 1, 65, 58",
			"2, 1, 58, 56",

			"3, 2, 74, 71, Alexandria",
			"3, 1, 66, 72",
			"3, 1, 80, 68",

			"4, 2, 36, 25",
			"4, 1, 46, 23",
			"4, 1, 44, 29",

			"5, 2, 25, 60, Cartharge",
			"5, 1, 34, 68",
			"5, 1, 42, 70"
    ],

    "players":
    [
		"Roman Crown, 255 0 0, roman",
    "Sparta, 0 0 255, spartanic",
		"Egypt Pharao, 255 255 0, egyptian",
		"Germanic Tribes, 0 0 0, germanic",
		"Cartharge, 200 200 200, cartharginian"
    ]
}
