{
	"name": "Westeros Full",
	"name_de": "Westeros Full",
	"size": "49x119",
	"tile_size": 40,

	"tile_map":
	[
		"WWWWWWWWWWWWWWWWWWWWWWWWWWWWWWWWWWWWWWWWWWWWWWWWW",
		"WWWWWWWWWWWWWWWWWWWWWWWWWWWWWWWWWWWWWWWWWWWWWWWWW",
		"WWWWWWWWWWWWWWWWWWWWWWWWWWWWWWWWWWWWWWWWWWWWWWWWW",
		"WWWWWWWWWWWWWWWWWWWWWWWWWWWWWWWWWWWWWWWWWWWWWWWWW",
		"WWWWWWWWWWWWWWWWWWWWWWWWWWWWWWWWWWWWWWWWWWWWWWWWW",
		"WWWWWWWWWWWWWWWWWWWWWWWWWWWWWWWWWWWWWWWWWWWWWWWWW",
		"WWWWWWWWWWWWWWWWWWWWWWWWWWWWWWWWWWWWWWWWWWWWWWWWW",
		"WWWWWWWWWWWWWWWWWWWWWWWWWWWWWWWWWWWWWWWWWWWWWWWWW",
		"WWWWWWWWWWWWWWWWWWWWWWWWWWWWWWWWWWWWWWWWWWWWWWWWW",
		"WWWWWWWWWWWWWWWWWWWWWWWWWWWWWWWWWWWWWWWWWWWWWWWWW",
		"WWWWWWWWWWWWWWWWWWWWWWWWWWWWWWWWWWWWWWWWWWWWWWWWW",
		"WWWWWWWWWWWWWWWWWWWWWWWWWWWWWWWWWWWWWWWWWWWWWWWWW",
		"WWWWWWWWWWWWWWWWWWWWWWWWWWWWWWWWWWWWWWWWWWWWWWWWW",
		"WWWWWWWWWWWWWWWWWWWWWWWWWWWWWWWWWWWWWWWWWWWWWWWWW",
		"WWWWWWWWWWWWWWWWWWWWWWWWWWWWWWWWWWWWWWWWWWWWWWWWW",
		"WWWWWWWWWWWWWWWWWWWWWWWWWWWWWWWWWWWWWWWWWWWWWWWWW",
		"WWWWWWWWWWWWWWWWWWWWWWWWWWWWWWWWWWWWWWWWWWWWWWWWW",
		"WWWWWWWWWWWWWWWSSSSSSSSSSSSSSSSSSSSWWWWWWWWWWWWWW",
		"WWWWWWWWWWWWWWWWWSSSSSSSSSSSSMMMMMMMMMWWWWWWWWWWW",
		"WWWWWWWWWWWWWWWWWMMMMSSSSSSSMMMMMMMMMMMWWWWWWWWWW",
		"WWWWWWWWWWWWWWWWMMMMMMMMMMMMMMMMMMMMMMMWWWWWWWWWW",
		"WWWWWWWWWWWWWWWWSSSSSSSMMMMMMMSSSMMMMMWWWWWWWWWWW",
		"WWWWWWWWWWWWWWWWSSSSSSSSMMMMMMMSSSSSSSWWWWWWWWWWW",
		"WWWWWWWWWWWWWWWWWSSSSSSSSSSSSSSSSSSSSSWWWWWWWWWWW",
		"WWWWWWWWWWWWWWWWWWSSSSSSSSSSSSSSSSSSSSWWWWWWWWWWW",
		"WWWWWWWWWWWWWWWWWWSSSSSSSFFFSSFFSSSSSSWWWWWWWWWWW",
		"WWWWWWWWWWWWWWWWWWMFFFFSFFFFFFFFGGSSSSSWWWWWWWWWW",
		"WWWWWWWWWWWWGGGWMMMMFFFFFFFFFFFGGGSSSSSWWWWWWWWWW",
		"WWWWWWWWWWGGGGGFFFMMMFFFFFFFFGGGGGGGSSGGWWWWWWWWW",
		"WWWWWWWWWWGGGGFFFFFFFMFFFFFFFGGGGGGGGGGGGWWWWWWWW",
		"WWWWWWWWWWGGGFFFFFFFFFFFFFFFFGGGGSSSGGGGGGWWWWWWW",
		"WWWWWWWWWWGGFFFFFFFFFFFFFFFFFGGGGSSSGGGGGGGGGGGWW",
		"WWWWWWWWWWGGFFFFFFFFFFFFFFFFFGGGGGSSGGGGGGGGGGWWW",
		"WWWWWWWWWWGGFFFFFFFFFFFFFFFFGGGGGGGGGGGFFGGGGWWWW",
		"WWWWWWWWWWWGFFFFFFFFFFFFFGGGGGGGGGGGGGFFFFGGGWWWW",
		"WWWWWWWWWWWGGFFFFFFFFFFFGGGGGGGGGGGGGGFFFFGGWWWWW",
		"WWWWWWWWWWWWGGFFFFFFGFFGGGGGGGGGGGGGGGFFFFGWWWWWW",
		"WWWWWWWWWWWWWGGGGGGGGGGGGGGGGGGGGGGGGFFFFFGWWWWWW",
		"WWWWWWWWWWWWGGGGGGGGGGGGGGGGGGGGGGGGFFFFFGWWWWWWW",
		"WWWWWWWWWWGGGGGGGGGGGGGGGGGGGGGGGGGGFFFFGGWWWWWWW",
		"WWWWWWWWGGGGGGGGGGGGGGGGGGGGGGGGGGGGFFFFFGWWWWWWW",
		"WWWWWWWWGGGGGGGGGGGGGGGGGGGGGGGGGGFFFFFFFGWWWWWWW",
		"WWWWWWWGGGGGGGGGGGGGGGGGGGGGGGGGGFFFFFFFFFWWWWWWW",
		"WWWWWWWGGGGGGGGGGGGGGGGGGGGGGGGGFFFFFFFFFFFWWWWWW",
		"WWWWWWWWGGGGGGGGGGGGGGGGGGGGGGGGFFFFFFFFFFFGWWWWW",
		"WWWWWWWWWGGGGGGGGGGGGGGGGGGGGGWGGFFFGWWFFFGGWWWWW",
		"WWWWWWWWWWGGGGGGGGGGGGGGGGGGGWWWGGGGWWWWWGGGWWWWW",
		"WWWWWWWWWWWWGGGGGGGGGGGWWGGGGGWWWGWWWWWWWWWGGWWWW",
		"WWWWWWWWWWWWWWWWGGGGGWWWGGGGGWWWWWWWWWWWWWWWWWWWW",
		"WWWWWWWWWWWWWWWWWWWWWWGFGGGGWWWWWWWWWWWWWWWWWWWWW",
		"WWWWWWGGWWWWWWWWWWWWWGFFFGGGWWWWWWWWWWWWWWWWWWWWW",
		"WWWWWGGGGGGGGGGWWWWWGFFFFGGGWWWWWWWWWWWWWWWWWWWWW",
		"WWWWWGGMMMGGGGGGGGGGFFFFFGGGGWWWWWWWWWWWWWWWWWWWW",
		"WWWWWGMMMMMGGGGMGGGFFFFFFGGGGWWWWWWWWWWWWWWWWWWWW",
		"WWWWWGMMMMMGGGMMMGGFFFFFFGGGGGWWWWWWWWWWWWWWWWWWW",
		"WWWWWGGMGMGGGGMMMMGFFFFFFGGGGWWWWWWWWWWWWWWWWWWWW",
		"WWWWWWGGGGGGGGGMMGGGFFFFFFGGGWWWWWWWWWWWWWWWWWWWW",
		"WWWWWWWGGGGGWGGGGGGGGGFFFGGGGWWWWWWWWWWWWWFWWWWWW",
		"WWWWWWWWWWWWWWWWWWWWWGFFFGGGGGGGWWWWWWWWFFFFWWWWW",
		"WWWWWWWWWWWWWWWWWWWWWWGFGGGGGGGGGGGFFFFFFFFFWWWWW",
		"WWWWWWWWWGGGWWWWWWWWGGGGGGGGGGGGGGFFFFFFFFFWWWWWW",
		"WWWWWWWWGGGGGWWWWGGGGGGGGGGGGGGGGFFFFFFFFFWWWWWWW",
		"WWWWWWWWGGGGGWWWGGGGGGGGGGGGGGGGMFFFFFFFFWWWWWWWW",
		"WWWWWWWWWGGGWWWGGGGGGGGGGGGGGGGGGGFFMFFFGWWWWWWWW",
		"WWWWWWWWWWWWWWWGGGGGGGGGGGGGGGGGGMMMMFFFGGWWWWWWW",
		"WWWWWWWGGWWWWWWWGGGGGGGGGGGGGGGMMMMMMFFFFWWWWWWWW",
		"WWWWWWMGGGWWGWWWWWGGGGGGGGGGGGGMMMMMMMFFGWWWWWWWW",
		"WWWWWMMMGGWGGGWWWWWWGGGGGGGGGGGMMMMMMMMMGGWWWWWWW",
		"WWWWWGMGGGWWGWWWWWWGGGGGGGGGGGMMMMMMMMMMGGWWWWWWW",
		"WWWWWWGGGWWWWWGGWWGGGGGGGGGGGGGMMMMGGGGGGGGWWWWWW",
		"WWWWWWWWWWWWWWWGGGGGGGGGGGGGGGMMMMGGGGGGGMGGGWWWW",
		"WWWWWWWWWWWWWWWGGGGGGGGGGGGGGGMMMMMMMMGGGGMGGGWWW",
		"WWWWWWWWWWWWWWWGGGGGGGGGGGGGGGGMMMMMMMMGGGGGGGWWW",
		"WWWWWWWWWWWWWWWGGGGGGGGGGWWWWGGMMMMMMMGGWWGGGWWWW",
		"WWWWWWWWWWWWWWWGGGGGGGGGGGGGWGGMMMMMMMGWWWWGWWWWW",
		"WWWWWWWWWWWWWWGGGGGGGGGGGGGGWWGGMMMMMMGGWWWWWWWWW",
		"WWWWWWWWWGGGGGGGGGGGGGGGGGGGGWWGGMMMMGGWWWWWWWWWW",
		"WWWWWWWWGGGGGGMMGGGGGGGGGGGGGGWWGGGGGGWWWWWWWWWWW",
		"WWWWWWWWWWGGGMMMMGGGGGGGGGWWWGGWWGGGGWWWWWWWWWWWW",
		"WWWWWWWWWWWGGMMMMMGGGGGGGWWWWWGWWWWWGWWWWWWWWWWWW",
		"WWWWWWWWWWWGGMMMMMGGGGGGGWWWWWWWGGGWWWWWWWWWWWWWW",
		"WWWWWWWWWWGGMMGGMMGGGGGGGGWWWGGGGGGGWWWWWWWWWWWWW",
		"WWWWWWWWGGGGMMGMMGGGGGGGGGGGGGGGGGGGWWWWWWWWWWWWW",
		"WWWWWWWGGGMGGMGGGGGGGGGGGGGGGGGGGGGGGWWWWWWWWWWWW",
		"WWWWWWWGGMMGGMMMGGGGGGGGGGGGGGGGGGGGGWWWWWWWWWWWW",
		"WWWWWWWGMMMGGMMMGGGGGGGGGGGGGGGGGGGGGWWWWWWWWWWWW",
		"WWWWWWWMMMMMGGGMGGGGGGGGGGGGGGGGGGGGGGWWGGGWWWWWW",
		"WWWWWWWGGGGGGGMGGGGGGGGGGGGGGGGGGGGGGGFFFGGGWWWWW",
		"WWWWWWWGGMMGGGGGGGGGGGGGGGGGGGGGGGGFFFFFFFGWWWWWW",
		"WWWWWWWMGMMMMMMMGGGGGGGGGGGGGGGGGGFFFFFFFGWWWWWWW",
		"WWWWWWWGGMMMMMMMMGGGGGGGGGGGGGGGGGFFFFFFFGWWWWWWW",
		"WWWWWWWWGFFMMMMMMGGGGGGGGGGGGGGGGGFFFFFFFGGWWWWWW",
		"WWWWWWWWFFFFMMMMMGGGGGGGGGGGGGGGGMMFFFFFFGGGWWWWW",
		"WWWWWWWWFFFFFMMMGGGGGGGGGGGGGGGGMMMMMFFFGGGWWWWWW",
		"WWWWWWWWFFFFFMMGGGGGGGGGGGGGMMMMMMMMMFFFFGGWWWWWW",
		"WWWWWWWWFFFFFGGGGGGGGGGGGGGMMMMMMMMMMFFFFFWWWWWWW",
		"WWWWWWWWGFFFFGGGGGGGGGGGGGMMMMMMMMMMFFFFFFFWWGGWW",
		"WWWWWWWWFFFFGGGGGGGGGGGGMGMMMMMMMMMGGFFFFFWWGGGWW",
		"WWWWWWWWWFFFFGGGGGGGGGGGGGGMMMMMMMGGGWWFFWWFFGWWW",
		"WWWWWWWWWWFFGGGGGGGGGGGMMGGGMMGGGGGGWWWWFWFFGWWWW",
		"WWWWWWWWWWWGGGGGGGGGGMMMMMGGMWWGWWWWWWWWWWWWWWWWW",
		"WWWWWWWWWWWGGGGGGGGGGGMMMMMGMMWWWWWWWWWWWWWWWWWWW",
		"WWWWWWWWWWGGGGGGGGGGGGGGGMGGGGWWWWWWWWWWWWWWWWWWW",
		"WWWWWWWWGGGGGGGGMMMMMGGGGGGGGGWWWWWWWWWWWWWWWWWWW",
		"WWWWWWWWGGGGGGGMMMMMMMGGGGGGGGWWWWWWWWWWWWWWWWWWW",
		"WWWWWWWGGGGGGGGMMMMMMMGMMMGGGGWWWWWWWWWWWWWWWWWWW",
		"WWWWWWWGGGGGGGGMMMMMMMMMMMGGGGWWWWWWWWWWWGGGGGGWW",
		"WWWWWWWGGGGGGGGMMMMMMMMMMMMGGGGWWGGGWWWWWGGGGGGWW",
		"WWWWWWGGGGGGGGGGMMMMMMMMGGGGGGGGGGGGGGWWGGGGGGGWW",
		"WWWWWGGGGGGGGGGMMMMMMMMGGGGGGGGGGGGGGGGGGGGGGGGWW",
		"WWWWWGGGGGGGGGGMMMMMMMMGGGGGGGGGGGGGGGGGGGGGGGGWW",
		"WWWWWWGGGWWWGGGGMMMMMMMMGGGGGGGGGGGGGGGGGGGGGGWWW",
		"WWWWWWWWWWWWWGGGGMGMMMMMGGGGGGGGGGGGGGGGGGGGGWWWW",
		"WWWWWWWWWWWWWGGGGGGGMMMGGGGGGGGGGGGGGGGGGGGWWWWWW",
		"WWWWWWWWWWWWGGGGGGGGGGGGGGGGGGGGGGGGGGGGGGWWWWWWW",
		"WWWWWWWWWWWWWWGGGGGGGGGGGGGGGGGGGGGGGGGWWWWWWWWWW",
		"WWWWWWWWWWWWWWWGGGGGGGGGGGGGGGGGGGGWWWWWWWWWWWWWW",
		"WWWWWWWWWWWWWWWWWWWWWWWWWWWWWWWWWWWWWWWWWWWWWWWWW",
		"WWWWWWWWWWWWWWWWWWWWWWWWWWWWWWWWWWWWWWWWWWWWWWWWW"
	],

	"cities":
	[
		"1 2 22 24",
		"2 1 12 5",
		"1 2 1 3"
	]
}